8 2 5 0 7 1 2
3 4 7 6 1 2 5
8 6 4 1 4 6 2
6 4 6 0 6 1 7
5 3 1 7 3 3 2
3 6 8 8 3 5 3
1 2 7 6 8 1 2
