7 2 0 0 7 1 3
3 4 7 6 1 7 8
8 7 6 1 4 8 3
6 4 8 0 6 1 7
5 5 1 7 3 3 2
3 1 5 5 7 0 3
1 2 1 6 2 1 2
